Alanine	A
Alanine-Arginine	R
Alanine-Asparagine	N
Alanine-Glycine	G
Alanine-Isoleucine	I
Alanine-Proline	P
Arginine	R
Arginine-Cysteine	C
Asparagine	N
Asparagine or Aspartate	N
Asparagine-Cysteine	C
Asparagine-Glycine	G
Asparagine-Lysine	K
Aspartate	D
Aspartate-Asparagine	N
Aspartate-Glycine	G
Cysteine	C
Cysteine-Arginine	R
Cysteine-Asparagine	N
Cysteine-Aspartate	D
Cysteine-Cysteine	C
Cysteine-Glutamate	E
Cysteine-Glutamine	Q
Cysteine-Glycine	G
Cysteine-Histidine	H
Cysteine-Phenylalanine	F
Cysteine-Selenocysteine	U
Cysteine-Serine	S
Cysteine-Threonine	T
Cysteine-Tryptophan	W
Cysteine-Tyrosine	Y
Glutamate	E
Glutamate-Cysteine	C
Glutamate-Glycine	G
Glutamate-Lysine	K
Glutamate-Tyrosine	Y
Glutamine	Q
Glutamine-Glycine	G
Glutamine-Lysine	K
Glycine	G
Glycine-Asparagine	N
Glycine-Aspartate	D
Glycine-Cysteine	C
Glycine-Glutamate	E
Glycine-Lysine	K
Glycine-Serine	S
Glycine-Threonine	T
Histidine	H
Histidine-Asparagine	N
Histidine-Aspartate	D
Histidine-Tyrosine	Y
Isoleucine	I
Isoleucine-Cysteine	C
Isoleucine-Proline	P
Isoleucine-Serine	S
Leucine	L
Leucine-Cysteine	C
Leucine-Leucine	L
Leucine-Tryptophan	W
Lysine	K
Lysine-Asparagine	N
Lysine-Aspartate	D
Lysine-Glutamate	E
Lysine-Glutamine	Q
Lysine-Glycine	G
Lysine-Methionine	M
Lysine-Threonine	T
Lysine-Tyrosine	Y
Methionine	M
Methionine-Glycine	G
Methionine-Lysine	K
Phenylalanine	F
Phenylalanine-Cysteine	C
Proline	P
Proline-Cysteine	C
Proline-Methionine	M
Proline-Tyrosine	Y
Selenocysteine-Cysteine	C
Serine	S
Serine-Asparagine	N
Serine-Cysteine	C
Serine-Cysteine-Serine	C
Serine-Glycine	G
Serine-Lysine	K
Serine-Serine	S
Serine-Serine-Cysteine	S
Serine-Threonine	T
Threonine	T
Threonine-Cysteine	C
Threonine-Glycine	G
Threonine-Lysine	K
Threonine-Threonine	T
Tryptophan	W
Tryptophan-Cysteine	C
Tryptophan-Tryptophan	W
Tryptophan-Tyrosine-Methionine	Y
Tyrosine	Y
Tyrosine-Cysteine	C
Tyrosine-Lysine	K
Tyrosine-Methionine-Tryptophan	M
Tyrosine-Tyrosine	Y
Undefined	X
Valine	V
Valine-Cysteine	C
Valine-Tyrosine	Y
